NO ./textures/blue.xpm
SO ./textures/brick.xpm
WE ./textures/grey.xpm
EA ./textures/wood.xpm

F 0,136,0
C 0,255,255

        111111111a1111111111111111
        100000000b0110000000000001
        101100000v1110000000000001
        1001000000x000000000000001
111111111011000001110000000000001
100000000011000001110111111111111
11110111111111011100000010001
11110111111111011101010010001
11000000110101011100000010001
10000000000000N0110000001000111111111111
10000000000000001101010010001
1100000101010101110101111000111a
11110111 1110101 101111010001
11111111 1111111 111111111111