NO ./textures/otterN.xpm
SO ./textures/sharkS.xpm
WE ./textures/catW.xpm
EA ./textures/pandaE.xpm

F 0,136,0

C 0,255,255
       
1111111111111111111111111
        100000000110000000000001
        1011000001110000000000001
        1001000000000000000000001
111111111011000001111111110000001
100000000011000001110111111111111
11110111111111011100000010001
11110111111111011101010010001
11000000110101011111111010001
10000000000000001100000010001
10000000000000001101010010001
1100000101010101110101111000111
1111E111 1110101 101111010001
11111111 1111111 111111111111