NO ./textures/otterN.xpm
SO ./textures/sharkS.xpm
WE ./textures/catW.xpm
EA ./textures/pandaE.xpm

F 0,136,0

C 0,255,255

1111111111111111111111111
1000000001110000000000001
1001000001110000N00000001
1001000000000000000000001
1111111111111111111111111