NO ./textures/otterN.xpm
SO ./textures/sharkS.xpm
WE ./textures/catW.xpm
EA ./textures/pandaE.xpm

F 0,136,0

C 0,255,255

1111111111111111111111111
1111111111111111111111111
1111111111111111111111111
1001000001N10000000000001
1111111111111111111111111