NO ./textures/otterN.xpm
SO ./textures/sharkS.xpm
WE ./textures/catW.xpm

F 0,136,0
C 0,255,25

111111111111111111111111111      
11111110111100111111111111
100000000000000000000000111
10000000000W000000000000001
100000000000000000000000111
111111111111111111111111111